wwwwwwwwwwwwwwwwwwwwwwwwwwwwwwwwwwwwwwwwwwwwwwwwwwwwwwwwwwwwww
w                                                            w
w                                                            w
w                                                            w
w                                                   fff      w
w                                               fff          w
w                                           fff              w
w                                       fff                  w
w                                  fff                       w
w                              fff                           w
w                          fff                               w
w                     ffff                                   w
w                  ff                                        w
w               ff                                           w
w           s      2                                         w
w        fffffffffffffffffffffffffffffffff                   w
w                                          f                 w
w                                             f              w
w                                                f           w
w                                                            w
w                                                   fff      w
w                                               fff          w
w                                           fff              w
w                                       fff                  w
w                                  fff                       w
w                              fff                           w
w                          fff                               w
w                     ffff                                   w
w                  ff                                        w
w               ff                                           w
w          fff                                               w
w       f                                                    w
w    f                                                      ew
ffffffffffffffffffffffffffffffffffffffffffffffffffffffffffffff
