wwwwwwwwwwwwwwwwwwwwwwwwwwwwwwwwwwwwwwwwwwwwwwwwwwwwwwwwwwwwww
w                                                            w
w                                                            w
w                                                            w
w                                                            w
w                                                      789   w
w                                                      456   w
w                                                      123   w
w                                                      fff   w
w                                                            w
w                                            fff             w
w   ff                                                       w
w                                                            w
w , <                                                        w
w . >                                    fff       rupzdhl   w
w . >                              fff             ti[xvj;   w
w / ?  ff                    fff                   yo]cgk#   w
w                  f   fff                                   w
w      ffffffff                                              w
w                                                            w
w            ffffff                                          w
w                        789                                 w
w                        456                                 w
w                        123                                 w
w                        fff  fffffff                        w
w   s                                                        w
w              fffffffff                                     w
w   ff                                                       w
w        ff                                                  w
w , <                                                        w
w . >      fff       rupzdhl                                 w
w . >                ti[xvj;                                 w
w / ?  ff            yo]cgk#                                ew
ffffffffffffffffffffffffffffffffffffffffffffffffffffffffffffff
