wwwwwwwwwwwwwwwwwwwwwwwwwwwwwwwwwwwwwwwwwwwwwwwwwwwwwwwwwwwwww
w                                 w w                        w
w                                 w w                        w
w        wwwwwwwwwwwwwwwwwwwwww   w w                        w
www   www    $$$$w                w w                        w
w  w  $$$        w      s        ww w      w   w   w         w
w                ww    wwwwwwwwwwwwww                 w      w
w   wwwwwwwww    w     w w             ww                    w
w 2   $$$$$     ww    ww w               wwwwwwwwwwwwwwwwwwwww
w                w     w w               w                   w
w   wwwwwww  w   ww    w www  wwwwwwwwwwww                   w
w   $$$$$$$      w     w w             w                     w
w w             ww    wwww             w                     w
wwwwwwwwwwwwwwwwww       wwwwwwww    www                     w
w                   w                  w                     w
w                  www                 w                     w
w                                      w                  1e w
w                        w             wwwwwwwwwwwwwwwwwwwwwww
w             wwwwwwwwwwww                                   w
w   wwwwwwwwwww                                              w
w   w                                                        w
w   w                                                        w
w   w                                                        w
w   w                                                        w
w   w                                                        w
w   w                                                        w
w   w                                                        w
w   w                                                        w
w   w                                                        w
w   w                                                        w
w   w                                                        w
w   w                                                        w
w   w                                                        w
w                                                            w
w                                                            w
wwwwwwwwwwwwwwwwwwwwwwwwwwwwwwwwwwwwwwwwwwwwwwwwwwwwwwwwwwwwww
