wwwwwwwwwwwwwwwwwwwwwwwwwwwwwwwwwwwwwwwwwwwwwwwwwwwwwwwwwwwwww
w                                                            w
wf                                                           w
w                                                            w
w            ffffff                                 fff      w
w                        789                    fff          w
w                        456                fff              w
w                        123            fff                  w
w                                  fff                       w
w                              fff                           w
w                          fff                               w
w   ff                ffff                                   w
w                  ff                                        w
w , <           ff                                           w
w . >       s                                      rupzdhl   w
w . >    fffffffffffffffffffffffffffffffff         ti[xvj;   w
w / ?  ff                    fff           f       yo]cgk#   w
w                  f   fff                    f              w
w      ffffffff                                  f           w
w                                                            w
w            ffffff                                 fff      w
w                        789                    fff          w
w                        456                fff              w
w                        123            fff                  w
w                                  fff                       w
w                              fff                           w
w                          fff                               w
w   ff                ffff                                   w
w                  ff                                        w
w , <           ff                                           w
w . >      fff       rupzdhl                                 w
w . >    ff          ti[xvj;                                 w
w / ?  ff            yo]cgk#                                ew
ffffffffffffffffffffffffffffffffffffffffffffffffffffffffffffff
